T,T,T,T,T,T,T,T,T,W,T,T,S
T,T,T,T,T,T,T,T,T,W,T,W
T,T,T,T,T,T,T,T,T,T,W,W
T,T,T,T,S,W,W,W,W,W,WC
T,T,T,T,T,T,T,T,T,T,W,W
T,T,T,T,T,T,T,T,T,W,T,W
T,T,T,T,T,T,T,T,T,W,T,T,W
T,T,T,T,T,W,W,W,W,T,T,T,T
T,T,W,T,T,W,T,T,T,T,T,T,T
T,T,W,T,W,T,T,T,T,T,T,T,T
T,T,T,W,W,T,T,T,T,T,T,T,T
TB1,W,BC,TP1,W,W,W,W,W,W,T,T,T
T,T,T,W,W,T,T,T,T,T,T,T,T
T,T,W,T,W,T,T,T,T,T,T,T,T
T,T,S,T,T,W,T,T,T,T,T,T,T