T,W,T,W,W,T,W,T,W,W,T,W
S,W,W,W,W,W,W,W,W,T,W,W
T,W,W,W,W,W,W,W,W,W,W,T,WC
T,W,W,W,W,W,W,W,W,W,W,W
T,W,T,W,W,W,W,W,W,W,W,W
W,W,W,W,W,W,W,W,W,W,W,S
T,W,W,W,W,W,W,W,W,W,W,W
W,W,W,W,W,W,W,W,W,W,W,W
T,W,W,W,W,W,W,W,W,W,W,W
S,W,W,W,W,W,W,W,W,W,W,W
T,W,W,W,W,W,W,W,W,W,W,W,W
BC,W,W,W,W,W,W,W,W,W,W,W,W
T,T,W,W,T,W,T,W,T,W,W,T,W
